Aa^Fpa, Ha, Aa, Aa, Gd, Aa^Fpa, Gd, Aa^Fpa, Aa^Fpa, Aa^Fpa, Aa^Fpa, Aa^Fpa, Aa^Fpa, Aa^Fpa, Aa^Fpa, Gd, Aa, Re, Rb, Rrc, Rb, Aa, Ww, Ww, Ai, Aa
Aa^Fpa, Aa, Aa, Aa, Gd, Aa^Vha, Aa^Fpa, Gd, Re, Aa^Fpa, Re, Gd, Re, Gll^Fp, Re, Aa^Fpa, Aa^Fpa, Gd, Rrc, Rrc, Aa, Ww, Wo, Wo, Ww, Ai
Aa^Fpa, Aa^Fpa, Ms, Aa, Gd, Aa^Fpa, Gd, Gd, Aa, Re, Aa, Re, Cea, Cea, Cea, Re, Re, Rrc, Rrc, Gd, Aa, Gd, Ww, Ww, Ai, Ww
Ms, Ms, Ms, Gd, Aa^Fpa, Gd, Aa, Aa, Aa, Aa, Aa, Aa^Fpa, Cea, 1 Ke, Cea, Aa^Fpa, Aa^Vha, Rb, Re, Aa^Fpa, Aa, Aa^Fpa, Aa^Fpa, Ww, Ww, Aa
Gll^Fp, Ms, Aa^Fpa, Aa^Fpa, Gd, Aa, Aa, Aa, Gd, Aa, Gd, Ha, Ha, Cea, Rb, Aa^Fpa, Rb, Rb, Re, Aa^Fpa, Aa, Aa^Fpa, Ms, Ms, Ai, Gd
Gll^Fp, Aa^Fpa, Gll^Fp, Aa^Fpa, Gd, Aa, Gd, Aa, Gd, Aa^Fpa, Aa^Fpa, Gd, Ha, Ha, Rb, Rb, Re, Re, Gd, Aa^Fpa, Aa, Ms, Ms, Ms, Aa, Aa
Aa^Fpa, Aa^Fpa, Gll^Fp, Aa^Fpa, Gd, Gd, Aa^Vha, Aa^Fpa, Aa^Fpa, Gll^Fp, Aa^Fpa, Aa^Vha, Gd, Rb, Rb, Rb, Ai, Ai, Ai, Aa, Aa, Ms, Ms, Ms, Aa, Aa
Aa^Fpa, Gll^Fp, Gll^Fp, Gll^Fp, Aa^Fpa, Aa^Fpa, Aa^Fpa, Aa^Fpa, Gll^Fp, Gll^Fp, Ms, Ms, Aa, Rb, Rb, Aa, Ai, Ai, Ai, Ai, Aa, Aa, Aa, Ms, Aa, Aa
Gll^Fp, Gll^Fp, Gll^Fp, Gll^Fp, Gll^Fp, Gll^Fp, Aa^Fpa, Gll^Fp, Gll^Fp, Ms, Ms, Ms, Aa^Fpa, Aa^Fpa, Re, Ai, Ai, Ai, Ww, Ai, Ai, Aa, Aa, Aa, Aa, Gd
Gll^Fp, Aa^Fpa, Aa^Fpa, Gll^Fp, Gll^Fp, Gll^Fp, Aa^Fpa, Aa^Fpa, Aa^Fpa, Ms, Ms, Aa, Aa, Rb, Re, Ai, Ai, Wo, Wo, Wo, Ai, Ai, Ai, Aa, Aa, Aa
Gd, Gd, Aa^Fpa, Aa^Fpa, Aa^Fpa, Gll^Fp, Aa^Fpa, Gd, Gd, Aa^Fpa, Aa^Fpa, Gd, Aa, Rb, Re, Aa^Vha, Ai, Wo, Wo, Wo, Ww, Ai, Ai, Aa, Aa, Aa
Aa, Aa, Gd, Gd, Gd, Aa^Fpa, Aa^Vha, Gd, Aa, Aa^Fpa, Aa, Aa, Aa, Rb, Re, Aa, Ai, Ai, Ww, Ww, Ww, Ai, Ai, Ai, Ai, Ai
Ms, Ms, Ms, Aa, Gd, Aa^Fpa, Ms, Ms, Ms, Aa, Ms, Aa^Fpa, Aa^Fma, Re, Aa, Aa, Ai, Ai, Ai, Ai, Ai, Aa, Ai, Ai, Ai, Ai
Ha, Ms, Aa, Aa, Ms, Ms, Aa^Fpa, Ms, Gll^Fp, Ms, Aa^Fma, Aa^Fma, Aa, Rb, Rb, Aa^Vca, Aa, Ai, Ww, Ww, Aa, Aa, Ai, Ai, Ai, Ai
Ha, Ms, Ms, Aa, Aa, Ha, Cea, Cea, Cea, Gll^Fp, Gll^Fp, Aa^Fpa, Rb, Rb, Re, Re, Ai, Ai, Ww, Ww, Ww, Gd, Ai, Ww, Ww, Ai
Aa, Ha, Ha, Ms, Ms, Aa, Cea, 2 Ke, Cea, Gd, Gd^Vh, Rb, Aa^Fpa, Re, Re, Aa, Aa, Ww, Ww, Ww, Ww, Ww, Ai, Ww, Ww, Ai
Gd^Vh, Aa, Aa, Ha, Ms, Aa, Aa, Cea, Aa, Gd, Aa^Fpa, Aa^Fpa, Aa^Fpa, Re, Aa, Re, Re, Gd^Vh, Gd, Ww, Ww, Ww, Ww, Ai, Ww, Ai
Ww, Ai, Ai, Aa, Ms, Aa, Ms, Aa, Ms, Ms, Re, Aa^Fpa, Gll, Gd, Aa, Aa, Re, Gd, Gd, Gd, Gd, Gd, Gd^Vh, Aa, Aa, Aa
Aa^Fpa, Ai, Ai, Aa, Ms, Ms, Aa, Ms, Aa, Re, Re, Gll^Fp, Aa, Aa, Aa, Aa, Aa, Re, Re, Aa, Aa, Aa, Aa, Aa, Aa, Aa
Ms^Xm, Ww, Ww, Ms, Aa, Aa, Aa, Aa, Re, Re, Aa^Vha, Gll, Aa^Fpa, Gd, Gd, Gd, Aa, Aa, Aa, Re, Re, Aa, Aa, Aa, Aa, Aa
Ms, Ms, Aa, Ww, Ww, Aa^Vha, Rb, Re, Gd, Gd, Aa, Aa, Aa^Fpa, Gd, Gd, Gd, Aa, Aa, Aa, Aa, Aa^Vha, Re, Aa, Aa, Aa, Ha
