Gs, Gs, Gs, Gs, Gs, Gs, Gs, Gs, Gs, Gs, Gs, Gg, Gg, Gg, Gs, Gg, Gs, Gg, Gs, Rrc, Gs
Gs, Gs, Gg, Gg, Gg, Gg, Gg, Gg, Gg, Gg, Xoi, Gg, Gg, Gs, Gg, Gs, Gg, Gs, Gg, Gs, Gs
Gs, Gg, Gg, Gg, Gg, Gg, Gg, Gg, Xoi, Xoi, Iwr, Xoi, Xoi, Gg, Gg, Gg, Gg, Gg, Gg, Gs, Gs
Gs, Gg, Gg, Gg, Gg, Gg, Xoi, Xoi, Iwr, Iwr, Iwr, Iwr, Iwr, Xoi, Xoi, Gg, Gg, Gg, Gg, Gs, Gs
Gs, Gg, Gg, Gg, Xoi, Xoi, Iwr, Iwr, Iwr, Iwr, Iwr, Iwr, Iwr, Iwr, Iwr, Xoi, Xoi, Gg, Gg, Gg, Gg
Gs, Gg, Xoi, Xoi, Iwr, Iwr, Iwr, Iwr, Ior, Iwr, Ior, Iwr, Ior, Iwr, Iwr, Iwr, Iwr, Xoi, Xoi, Gg, Gg
Gs, Gg, Xos, Iwr, Iwr, Iwr, Iwr, Iwr, Iwr, Ior, Iwr, Ior, Iwr, Iwr, Iwr, Iwr, Iwr, Iwr, Xos, Gg, Gg
Gg, Gg, Xos, Iwr, Iwr, Iwr, Iwr^Ebn, Iwr, Iwr, Iwr, Iwr, Iwr, Iwr, Iwr, Iwr^Ebn, Iwr, Iwr, Iwr, Xos, Gg, Gg
Gg, Gg, Xos, Iwr, Iwr, Iwr, Iwr^Ebn, Iwr, Iwr, Iwr, Iwr, Iwr, Iwr, Iwr, Iwr^Ebn, Iwr, Iwr, Iwr, Xos, Gg, Gg
Gg, Gg, Xos, Iwr, Iwr, Iwr, Iwr^Ebn, Iwr, Iwr, Iwr, Iwr, Iwr, Iwr, Iwr, Iwr^Ebn, Iwr, Iwr, Iwr, Xos, Gg, Gg
Gg, Gg, Xos, Iwr, Iwr, Iwr, Iwr, Iwr, Ior, Iwr, Iwr, Iwr, Ior, Ior, Ior, Iwr, Iwr, Iwr, Xos, Gg, Gg
Gg, Gg, Xoi, Ior, Xoi, Xoi, Xoi, Xoi, Xoi, Iwr, Iwr, Iwr, Xoi, Xoi, Xoi, Xoi, Xoi, Ior, Xos, Gg, Gg
Gg, Gg, Xoi, Xoi, Ior, Ior, Iwr, Iwr, Iwr, Ior, Iwr, Ior, Iwr^Efs, Iwr, Iwr, Iwr, Iwr, Xoi, Xoi, Gg, Gg
Gg, Gg, Xos, Ior, Iwr, Iwr, Iwr, Iwr, Iwr^Efs, Iwr, Iwr, Iwr, Iwr^Efs, Iwr, Iwr, Iwr, Iwr, Ior, Xos, Gg, Gg
Gg, Gg, Xos, Ior, Iwr, Iwr, Iwr, Iwr, Iwr^Efs, Iwr, Iwr, Iwr, Iwr^Efs, Iwr, Iwr, Iwr, Iwr, Ior, Xos, Gg, Gg
Gg, Gg, Xos, Ior, Iwr, Iwr, Iwr, Iwr, Iwr^Efs, Iwr, Iwr, Iwr, Iwr^Efs, Iwr, Iwr, Iwr, Iwr, Ior, Xos, Gg, Gg
Gg, Gg, Xos, Ior, Iwr, Iwr, Iwr, Iwr, Iwr^Efs, Iwr, Iwr, Iwr, Iwr^Efs, Iwr, Iwr, Iwr, Iwr, Ior, Xos, Gg, Gg
Gg, Gg, Xos, Ior, Ior, Iwr, Iwr, Iwr, Iwr^Efs, Iwr, Iwr, Iwr, Iwr^Efs, Iwr, Iwr, Iwr, Ior, Ior, Xos, Gg, Gg
Gg, Gg, Gg, Xos, Xos, Ior, Ior, Ior, Ior^Efs, Iwr, Iwr, Iwr, Iwr^Efs, Iwr, Ior, Ior, Xos, Xos, Gg, Gg, Gg
Gg, Gg, Gg, Gg, Gg, Xos, Xos, Ior, Ior^Efs, Ior, 1 Iwr, Iwr, Ior^Efs, Iwr, Xos, Xos, Gg, Gg, Gg, Gg, Gg
Gg, Gg, Gg, Gg, Gg, Gg, Gg, Xos, Xos, Iwr, Xos, Iwr, Xos, Xos, Gg, Gg, Gg, Gg, Gg, Gg, Gg
Gg, Gg, Gg, Gg, Gg, Gg, Gg, Gg, Gg, Urb, Urb, Urb, Gg, Gg, Gg, Gg, Gg, Gg, Gg, Gg, Gg
Rrc, Gg, Rrc, Gg, Rrc, Gg, Rrc, Gg, Rrc, Urb, Rrc, Urb, Rrc, Gg, Rrc, Gg, Rrc, Gg, Rrc, Gg, Rrc
