border_size=1
usage=map

Md^Xm, Md^Xm, Md^Xm, Md^Xm, Md^Xm, Md^Xm, Md, Md, Md, Rb, Gd, Rb, Rb, Rb, Rb, Rb, Rb, Rb, Hhd, Hhd, Hhd, Rb, Md, Md, Md, Md, Md, Md, Md, Rb, Md, Rb, Md, Md, Md, Rb, Md^Xm, Md^Xm, Md^Xm, Md^Xm, Md^Xm, Rb, Md^Xm, Md^Xm, Md^Xm, Md^Xm, Rb, Rb, Rb, Rb, Mm, Rb, Md^Xm, Rb, Md^Xm, Rb, Md^Xm, Rb, Md^Xm, Md^Xm, Md^Xm, Md^Xm, Md^Xm, Md^Xm, Md^Xm
Md^Xm, Md^Xm, Md^Xm, Md^Xm, Md^Xm, Md^Xm, Md, Md, Md, Gd, Gd, Rb, Rb, Rr, Rb, Rb, Gd, Gd, Hhd, Hhd, Hhd, Md, Md, Md, Md, Md, Md, Md, Md, Md, Md, Md, Md, Md, Md, Md^Xm, Md^Xm, Md^Xm, Md^Xm, Md^Xm, Md^Xm, Md^Xm, Md^Xm, Md^Xm, Md^Xm, Md^Xm, Mm, Mm, Mm, Mm, Mm, Mm, Mm, Md^Xm, Md^Xm, Md^Xm, Md^Xm, Md^Xm, Md^Xm, Md^Xm, Md^Xm, Md^Xm, Md^Xm, Md^Xm, Md^Xm
Md^Xm, Md^Xm, Md^Xm, Md^Xm, Md^Xm, Md, Md, Md, Md, Gd, Gd, Rb, Rb, Rr, Rb, Rb, Gd, Gd, Gd, Hhd, Hhd, Md, Md, Md, Md, Md, Md, Md, Md, Md, Md, Md, Md, Md, Md, Md^Xm, Md, Md^Xm, Md, Md^Xm, Md^Xm, Md^Xm, Md^Xm, Md^Xm, Md^Xm, Md^Xm, Mm, Mm, Mm, Mm, Mm, Mm, Mm, Md^Xm, Mm, Md^Xm, Md^Xm, Md^Xm, Md^Xm, Md^Xm, Md^Xm, Md^Xm, Md^Xm, Md^Xm, Md^Xm
Md^Xm, Md^Xm, Md^Xm, Md^Xm, Md, Md, Md, Md, Md, Gd, Gd, Rb, Rb, Rr, Rb, Rb, Gd, Gd^Fetd, Gd^Es, Hhd, Hhd, Hhd, Hhd, Md, Md, Md, Md, Md, Md, Md, Md, Md, Md, Md, Md, Md, Md, Md, Md, Md, Md^Xm, Md^Xm, Md^Xm, Md^Xm, Md^Xm, Mm, Mm, Mm, Mm, Mm, Mm, Mm, Mm, Mm, Mm, Mm, Mm, Md^Xm, Md^Xm, Md^Xm, Md^Xm, Md^Xm, Md^Xm, Md^Xm, Md^Xm
Rb, Md^Xm, Md, Md, Md, Md, Md, Md, Md, Gd, Gd^Fetd, Rb, Rb, Rr, Rb, Rb, Gd^Es, Gd, Gd, Gd, Gd, Hhd, Hhd, Hhd^Em, Hhd, Md, Md, Md, Md, Md, Md, Md, Md, Md, Md, Md, Md, Md, Md, Md, Md, Md, Md, Md^Xm, Md^Xm, Mm, Mm, Mm, Mm, Mm, Mm, Mm, Hhd, Hhd, Rp, Md, Mm, Mm, Mm, Md^Xm, Md^Xm, Md^Xm, Md^Xm, Md^Xm, Md^Xm
Md, Md, Md, Md, Md, Md, Md, Md, Md, Gd, Rb, Rb, Rb, Rr, Rb, Rb, Rb, Gd, Gd^Fetd, Gd^Fetd, Rb, Rb, Rb, Hhd, Hhd, Hhd, Hhd, Md, Md, Md, Md, Md, Md, Md, Md, Md, Md, Md, Md, Md, Md, Md, Md, Md, Md^Xm, Mm, Mm, Mm, Rb, Mm, Hhd, Hhd, Rp, Rp, Rp^Yr, Rp, Rp, Mm, Mm, Mm, Mm, Md^Xm, Md^Xm, Md^Xm, Rb
Md, Md, Md, Md, Rb^Edb, Md, Md, Md, Rb, Rb, Rb, Rb, Rb, Rr, Rb^Es, Rb, Rb, Rb, Rb, Rb, Rb, Rb, Rb, Rb, Rb, Hhd, Hhd, Hhd, Hhd, Hhd, Hhd, Hhd, Hhd, Md, Hhd, Md, Md, Md, Md, Md, Md, Md, Md, Md, Md^Xm, Md^Xm, Rb, Rb, Rb, Rb, Rp, Rp, Rp, Rp, 3 Rp, Rp^Yr, Rp^Yr, Rp, Mm, Mm, Mm, Md^Xm, Md^Xm, Md^Xm, Rb
Rb, Md, Rb, Rb, Rb, Rb, Rb, Rb, Rb, Rb, Rb, Rb^Es, Rb, Rr, Rb, Rb^Es, Rb, Rb, Rb, Rb, Rb, Rb^Es, Rb^Es, Rb, Rb, Rb, Rb, Hhd, Hhd, Hhd, Hhd, Hhd, Hhd, Hhd, Hhd, Hhd, Hhd, Md, Md, Md, Md, Md, Md, Md, Md, Rb, Rb, Rb, Rb, Rb, Rp, Rp, Rp, Rp, Rp, Rp, Hhd, Hhd, Mm, Mm, Mm, Mm, Mm, Md^Xm, Md^Xm
Rb, Rb, Rb, Rb, Rb, Rb, Rb, Rb, Rb, Rb, Rb^Es, Rb^Es, Rb, Rr, Rb, Rb^Es, Rb^Es, Rb, Rb, Rb, Rb^Em, Rb, Rb, Rb^Es, Rb^Es, Rb, Rb, Rb, Rb, Hhd, Hhd, Hhd, Hhd, Hhd, Hhd, Hhd, Hhd, Md, Md, Md, Md, Md, Md, Md, Md, Rb, Rb, Rb, Rr, Rr, Rb, Rp, Rp, Rp, Hhd, Hhd, Mm, Mm, Mm, Mm, Mm, Mm, Mm, Md^Xm, Md^Xm
Rb, Rb, Rb, Rb, Rb^Em, Rb, Rb, Rb, Rb, Rb, Rb, Rb^Es, Rb^Es, Rr, Rb, Rb^Es, Rb, Rb, Rb, Rb, Rb, Rb, Rb, Rb, Rb, Rb, Rb, Rb, Rb, Rb, Rb, Rb, Rb, Hhd, Rb, Hhd, Rb, Hhd, Hhd, Md, Md, Md, Md, Md, Md, Rb, Rb, Rb, Rr, Rb, Rb, Rb, Md, Md, Md, Mm, Md^Xm, Mm, Mm, Mm, Mm, Mm, Mm, Md^Xm, Rb
Rb, Rb, Rb, Rb, Rb, Rb, Rb, Rb, Rb, Rb^Es, Rb, Rb, Rb^Es, Rr^Es, Rb, Rb^Es, Rb, Rb, Rb, Rb, Rb, Rb, Rb, Rb, Rb, Rb, Hhd, Hhd, Hhd, Rb, Rb, Rb, Rb, Rb, Rb, Rb, Rb, Hhd, Hhd, Hhd, Hhd, Md, Mm, Mm, Hhd, Rb, Rb, Rb, Rr, Rb, Rb, Md, Md, Md, Md, Md^Xm, Md^Xm, Md^Xm, Mm, Mm, Mm, Mm, Md^Xm, Md^Xm, Md^Xm
Rb, Rb, Rb, Rb, Rb, Rb, Rb^Em, Rb, Rb, Rb, Rb, Rb, Rb, Rr, Rb, Rb, Rb, Rb, Rb, Rb, Rb^Em, Rb^Es, Rb, Rb, Hhd, Hhd, Hhd, Hhd, Hhd, Hhd, Hhd, Rb, Rb, Rb, Rb, Rb, Rb, Rb, Hhd, Hhd, Mm, Mm, Mm, Mm, Hhd, Rb, Rb, Rb, Rr, Rb, Rb, Md, Md, Md, Md^Xm, Md^Xm, Md^Xm, Md^Xm, Md^Xm, Md^Xm, Md^Xm, Md^Xm, Md^Xm, Md^Xm, Md^Xm
Md, Md, Md, Md, Md, Rb, Rb, Rb, Rb^Em, Rb, Rb, Rb, Ket, Rr, Ket, Rb, Rb, Rb, Rb^Es, Rb, Rb^Es, Rb^Es, Hhd, Hhd, Hhd^Em, Hhd^Em, Md, Md, Md, Hhd, Hhd, Hhd, Rb, Rb, Rb, Rb, Rb, Rb, Hhd, Hhd, Mm, Mm, Mm, Mm, Hhd, Hhd, Rb, Rb, Rr, Rb, Rb, Md, Md, Md^Xm, Md^Xm, Md^Xm, Md^Xm, Md^Xm, Md^Xm, Md^Xm, Md^Xm, Md^Xm, Md^Xm, Md^Xm, Md^Xm
Md, Md, Md, Md, Md, Md, Mm, Mm, Rb, Rb, Rb, Rb, Rb, Rr, Rb, Rb, Rb, Rb, Rb, Rb^Es, Rb, Rb, Hhd, Hhd, Md, Md, Md, Md, Md, Hhd, Hhd, Hhd, Hhd, Rb, Rb^Es, Rb^Es, Rb^Es, Rb^Es, Hhd, Mm, Mm, Mm, Mm, Hhd, Rb, Hhd, Rb, Rb, Rr, Rb, Rb, Md, Md, Md^Xm, Md^Xm, Md^Xm, Md^Xm, Md^Xm, Md^Xm, Md^Xm, Md^Xm, Md^Xm, Md^Xm, Md^Xm, Md^Xm
Md, Md, Md, Md, Mm, Mm, Mm, Mm, Rb, Rb, Rb, Rb, Rb, Rr, Rb, Rb, Rb, Rb, Rb, Rb, Rb, Rb^Edb, Hhd, Hhd, Md, Md, Md, Md, Md, Hhd, Hhd, Hhd, Hhd, Rb, Rb, Rb, Rb, Hhd, Hhd, Mm, Mm, Mm, Mm, Hhd, Hhd, Rb, Rb, Rb, Rr, Rb, Rb, Md, Md, Md^Xm, Md^Xm, Md^Xm, Md^Xm, Md^Xm, Md^Xm, Md^Xm, Md^Xm, Md^Xm, Md^Xm, Md^Xm, Md^Xm
Mm, Md, Mm, Mm, Mm, Mm, Hhd, Mm, Rb, Rb, Rb^Es, Rb^Es, Rb, Rr, Rb, Rb, Rb, Rb, Rb, Rb, Rb, Hhd, Hhd, Hhd, Gd^Fetd, Md, Hhd, Md, Md, Hhd, Hhd, Hhd, Hhd, Hhd, Rb, Rb, Rb, Hhd, Hhd, Mm, Mm, Mm, Mm, Hhd, Hhd, Rb, Rb, Rb, Rr, Rb, Rb, Md, Md, Md^Xm, Md^Xm, Md^Xm, Md^Xm, Md^Xm, Md^Xm, Md^Xm, Md^Xm, Md^Xm, Md^Xm, Md^Xm, Rb
Mm, Mm, Mm, Mm, Hhd, Hhd, Rb, Hhd, Rb^Es, Rb^Es, Rb, Rb, Rr, Rr, Rr, Rb, Rb, Rb, Rb, Rb, Rb, Rb, Rb, Gd^Fetd, Gd^Fetd, Gd^Fetd, Hhd, Mm, Mm, Hhd, Hhd, Hhd, Hhd, Rb, Rb, Rb, Rb^Em, Rb, Hhd, Mm, Mm, Mm, Hhd, Hhd, Rb, Rb, Rb, Rr, Rb, Rb, Rb, Rb, Md, Md^Xm, Md^Xm, Md^Xm, Md^Xm, Md^Xm, Md^Xm, Md^Xm, Md^Xm, Md^Xm, Md^Xm, Md^Xm, Rb
Mm, Mm, Mm, Hhd, Hhd, Hhd, Rb, Rb, Rb, Rb, Rb, Rb, Ch, Rr, Rr, Ch, Rb, Rb, Rb, Rb, Rb, Rb, Rb, Gd^Fetd, Gd^Fetd, Gd^Fetd, Hhd, Mm, Mm, Hhd, Hhd, Hhd, Hhd, Rb, Rb, Rb, Rb^Em, Rb, Rb, Hhd, Hhd, Hhd, Rb, Rb, Rb, Rb, Rr, Rr, Rb, Rb, Rb, Rb, Md, Md, Md^Xm, Md^Xm, Md^Xm, Md^Xm, Md^Xm, Md^Xm, Md^Xm, Md^Xm, Md^Xm, Md^Xm, Rb
Md, Md, Md, Hhd, Hhd, Rb, Rb, Rb, Rb, Rb, Rb, Rb, Xos, Rr, Rrc, Xos, Xos, Rb, Xos, Xos, Xos, Rb, Rb, Rb, Rb, Rb, Rb, Hhd, Hhd, Hhd, Hhd, Hhd, Hhd, Hhd, Rb, Rb, Rb, Rb, Rb^Es, Rb^Es, Rb, Rb, Rb^Es, Rb^Es, Rr, Rr, Rb, Rb, Rb, Rb, Md^Xm, Md, Md, Md, Md^Xm, Md^Xm, Md^Xm, Md^Xm, Md, Md^Xm, Md^Xm, Md^Xm, Md^Xm, Md^Xm, Rb
Md, Md, Md, Hhd, Hhd, Rb, Rb, Rb, Rb, Rb, Xos, Xos, Rrc, Rrc, Rrc, Rrc, Rrc, Xos, Rrc, Rrc, Rrc, Xos, Xos, Rb, Rb, Rb, Rb, Rb, Rb, Hhd, Hhd, Hhd, Hhd, Hhd, Hhd, Rb, Rb, Rb^Em, Rb, Rb^Es, Rb, Rb, Rb, Rb^Em, Rr, Rb, Rb, Rb, Rb, Rb, Md, Md, Md, Md, Md^Xm, Md, Md, Md, Md, Md^Xm, Md^Xm, Md^Xm, Md^Xm, Md^Xm, Md^Xm
Rb, Md, Hhd, Hhd, Rb, Rb, Rb, Rb, Xos, Xos, Rrc, Rrc, Rrc, Rrc, Rrc, Rrc, Ql, Rrc, Rrc, Rrc, Rrc, Rrc, Rrc, Xos, Xos, Rb, Rb, Rb, Rb, Hhd, Hhd, Hhd, Hhd, Hhd, Hhd, Rb, Rb, Rb^Em, Rb, Rb^Es, Rb^Es, Rb, Rr, Rr, Rb, Rb, Rb, Rb, Rb, Rb, Md, Md, Md, Md, Md^Xm, Md, Md, Md, Md, Md, Md^Xm, Md^Xm, Md^Xm, Md^Xm, Md^Xm
Rb, Hhd, Rb, Rb, Rb, Rb, Xos, Xos, Rrc, Rrc, Rrc, Rrc, Rrc, Rrc, Ql, Ql, Xos, Ql, Ql, Rrc, Rrc, Rrc, Rrc, Rrc, Rr^Vhc, Xos, Xos, Rb, Rb, Rb, Hhd, Hhd, Hhd, Hhd, Hhd, Hhd, Rb, Rb, Rb^Em, Rb, Rb, Rb, Rr, Rb, Rb, Rb, Rb, Rb, Md, Md, Md, Md, Md, Md, Md^Xm, Md, Rb, Md, Md, Md, Md, Md^Xm, Md^Xm, Md^Xm, Md^Xm
Rb, Rb^Es, Rb^Es, Rb, Rb, Rb, Xos, Rrc, Rrc, Rrc, Rrc, Rrc, Rrc, Ql, Xos, Xos, Urb, Xos, Xos, Ql, Rrc, Rrc, Rrc, Rrc, Rr^Vhc, Rr^Vhc, Xos, Rb, Rb, Rb, Rb, Hhd, Rb, Rb, Rb, Rb, Rb, Rb, Rb, Rb^Em, Rb, Rb^Em, Rr, Rb, Rb, Rb, Rb, Md, Md, Md, Md, Md, Md, Md, Rb, Rb, Rb, Md, Md, Md, Md, Md^Xm, Md^Xm, Md^Xm, Md^Xm
Rb, Rb, Rb^Es, Rb, Rb, Rb, Xos, Rrc, Rrc, Rrc, Rrc, Rrc, Rrc, Ql, Xos, Urb, Uu^Yf, Urb, Xos, Ql, Rrc, Rrc, Rrc, Rrc, Rrc, Rrc, Xos, Rb, Rb, Rb, Rb, Rb, Rb, Rb, Rb, Rb, Rb, Rb, Rb, Rb, Rb^Cov, Rb^Cov, Rr^Cov, Rb, Rb, Rb, Rb, Md, Md, Md, Rb, Rb, Rb, Md, Rb, Rb, Md, Md, Md, Md, Md, Md^Xm, Md^Xm, Md^Xm, Md^Xm
Rb, Rb, Rb^Es, Rb, Rb, Rb, Xos, Rrc, Rrc, Rrc, Rrc, Rrc, Rrc, Ql, Ur, Urb, Urb, Urb, Xos, Ql, Rrc, Rrc, Rrc, Rrc, Rrc, Rrc, Xos, Rb, Rb, Rb, Rb, Rb, Gd^Fetd, Rb, Rb, Rb, Rb, Rb, Rb, Rb^Cov, Rb^Cov, Rb^Cov, Rr^Cov, Rb^Cov, Rb, Rb, Rb, Rb, Rb, Rb, Rb, Rb, Rb, Rb, Md, Md, Md, Md, Md, Md, Md, Md^Xm, Md^Xm, Md^Xm, Md^Xm
Rb, Rb, Rb, Rb^Es, Rb, Rb, Xos, Rrc, Rrc, Rrc, Rrc, Rrc, Rrc, Qxu^Bs/, Ql, Xos, Xos, Xos, Ql, Ql, Rrc, Rrc, Rrc, Rrc, Rrc, Xos, Ch, Rb, Rb, Rb, Gd^Fetd, Gd^Fetd, Rb, Rb, Rb, Rb, Rb, Rb, Rb, Rb^Cov, Rr^Cov, Rr^Kov, Rb^Cov, Rb^Cov, Rb, Rb, Rb, Rb, Rb, Rb, Rb, Rb, Rb, Rb, Md, Md, Md, Md, Md, Md, Md, Md^Xm, Md^Xm, Md^Xm, Md^Xm
Rb, Rb, Rb, Rb^Es, Rb, Rb, Xos, Rrc, Rrc, Rrc, Rrc, Rrc, Rrc, Rrc, Rrc, Ql, Ql, Ql, Rrc, Rrc, Rrc, Rrc, Rrc, Rrc, Rrc, Rr, Rr, Rr, Rb, Rb, Gd^Fetd, Gd^Fetd, Ket, Rb, Rr, Rb, Rr, Rr, Rr, Rr^Cov, Rb^Cov, Rb^Cov, Rb^Cov, Rb^Cov, Rb, Rb, Rb, Rb, Rb, Rb, Rb, Rb, Rb, Rb, Md, Md, Md, Md, Md, Md, Md, Md, Md^Xm, Md^Xm, Md^Xm
Rb, Rb, Rb, Rb, Rb, Rb, Xos, Rrc, Ch, Rrc, Rrc, 1 Rrc, Rrc, Rrc, Rrc, Rrc, Rrc, Rrc, Rrc, Rrc, Rrc, Rrc, Rrc, Rrc, Xos, Rr, Rr, Rr, Rr, Rb, Rr, Rb, Rr, Rr, Rb, Rr, Rb, Rb, Rb, Rr, Rr, Rb^Cov, Rb, Rb, Rb, Rb, Rb, Rb, Rb, Rb, Rb, Rb, Rb, Rb, Md, Md, Md, Md, Md, Md, Md, Md, Md^Xm, Md^Xm, Md^Xm
Rb, Rb, Rb, Rb, Rb^Es, Rb, Xos, Ch, 2 Kh, Ch, Rrc, Rrc, Rrc, Rrc, Rrc, Rrc, Rrc, Rrc, Rr^Vhc, Rr^Vhc, Rr^Vhc, Rrc, Xos, Xos, Rb, Ch, Rb, Rb, Rb, Rr, Rb, Rr, Ket, Rb, Rb, Rb, Rb, Rb, Rb, Rb, Rb, Rr, Rb, Rb, Rb, Rb, Rb, Rb, Rb, Rb, Rb, Rb, Rb, Rb, Md, Md, Md, Md, Rb, Md, Md, Md, Md^Xm, Md^Xm, Md^Xm
Rb, Rb, Rb, Rb^Es, Rb, Rb, Xos, Ch, Ch, Ch, Rrc, Rrc, Rrc, Rr^Vd, Rr^Vd, Rrc, Xos, Xos, Xol, Rr^Vhc, Xos, Xos, Rb, Rb, Rb, Rb, Rb, Rb, Gd^Fetd, Rb, Gd^Fetd, Gd^Fetd, Rb, Rb, Rb, Rb, Rb, Rb, Rb, Rb, Rb^Es, Rr, Rr, Rb, Rb, Rb, Rb, Rb, Rb, Rb, Rb, Rb, Rb, Rb, Rb, Md, Rb, Rb, Rb, Md, Md, Md, Md^Xm, Md^Xm, Md^Xm
Rb, Rb, Hhd, Rb, Rb, Rb, Rb, Xos, Xos, Xos, Xos, Rrc, Xos, Rr^Vd, Xos, Xos, Rb, Rb, Rb, Xos, Rb, Rb, Rb, Rb, Rb, Rb, Rb, Sm, Sm, Gd^Fetd, Rb, Rb, Rb, Rb, Rb, Rb, Rb^Es, Rb^Es, Rb^Es, Rb^Es, Rb, Rb^Es, Rr, Rb, Rb, Rb, Rb, Rb, Rb, Rb, Rb, Rb, Rb, Rb, Rb, Rb, Rb, Rb, Rb, Rb, Md, Md, Md^Xm, Md^Xm, Md^Xm
Rb, Hhd, Hhd, Hhd, Hhd, Rb, Rb, Rb, Rb, Rb, Rb, Xos, Rb, Xos, Rb, Rb, Rb, Rb, Rb, Rb, Rb, Rb, Rb, Rb, Rb, Rb, Sm, Sm, Sm, Sm, Rb, Rb, Rb^Es, Rb, Rb, Rb, Rb, Rb, Rb, Rb, Rb, Rb, Rb, Rr, Rb, Rb, Rb, Rb, Rb, Rb, Rb, Rb, Rb, Rb, Rb, Rb, Rb, Rb, Md, Md, Md, Md, Md^Xm, Md^Xm, Md^Xm
Md, Md, Md, Hhd, Hhd, Rb, Rb, Rb, Rb, Rb, Rb, Rb, Rb, Rb, Rb, Rb, Rb^Es, Rb, Rb^Es, Rb^Es, Rb, Rb, Gd^Fetd, Gd^Fetd, Gd^Fetd, Gd^Fetd, Sm, Sm, Sm, Sm, Rb, Rb^Es, Rb, Rb, Rb, Rb, Rb, Rb, Md, Md, Md, Rb, Rb^Es, Rr, Rb, Rb, Rb, Rb, Rb, Rb, Rb, Rb, Rb, Rb, Md, Rb, Md, Md, Md, Md, Md^Xm, Md^Xm, Md^Xm, Md^Xm, Md^Xm
Rb, Md, Md, Md, Md, Hhd, Hhd, Hhd, Hhd, Rb, Rb, Rb, Rb, Rb, Rb, Rb^Es, Rb, Rb^Es, Rb, Rb, Rb, Rb, Rb, Rb, Sm, Sm, Sm, Sm, Sm, Sm, Sm, Rb, Rb, Rb, Rb, Rb, Rb, Rb, Md, Md, Md, Rb, Rr, Rr, Rb, Rb, Rb, Rb, Md, Rb, Md, Md, Md, Md, Md, Md, Md, Md, Md^Xm, Md^Xm, Md^Xm, Md^Xm, Md^Xm, Md^Xm, Md^Xm
Rb, Ms^Xm, Ms^Xm, Md, Md, Md, Md, Hhd, Hhd, Hhd, Hhd, Rb, Rb, Rb, Rb, Rb, Rb, Rb, Rb, Rb, Rb, Rb, Gd^Fetd, Gd^Fetd, Gd^Fetd, Sm, Sm, Sm, Sm, Sm, Hhd, Rb, Rb, Rb, Rb^Edb, Rb^Edb, Md, Md, Md, Md, Md, Rb, Rr, Rb, Rb, Rb, Md, Md, Md, Md, Md^Xm, Md, Md^Xm, Md, Md^Xm, Rb, Md^Xm, Md^Xm, Md^Xm, Md^Xm, Md^Xm, Md^Xm, Md^Xm, Md^Xm, Md^Xm
Rb, Ms^Xm, Ms^Xm, Ms^Xm, Md, Md, Md, Md, Md, Hhd, Hhd, Hhd, Rb^Es, Rb^Es, Rb^Es, Rb^Es, Rb^Es, Rb^Es, Rb, Rb, Rb, Rb, Rb, Gd^Fetd, Rb, Sm, Sm, Sm, Sm, Sm, Hhd, Hhd, Hhd, Rb, Md, Md, Md, Md, Md, Md, Rb, Rb, Rr, Rb, Md, Md, Md, Md, Md^Xm, Md^Xm, Md^Xm, Md^Xm, Md^Xm, Md^Xm, Md^Xm, Md^Xm, Md^Xm, Md^Xm, Md^Xm, Md^Xm, Md^Xm, Md^Xm, Md^Xm, Md^Xm, Rb
Rb, Ms^Xm, Hhd, Ms^Xm, Hhd, Md, Md, Md, Md, Md, Rb, Hhd, Rb, Rb, Rb, Rb, Rb, Rb, Rb, Rb, Rb, Rb, Rb, Rb, Rb, Sm, Sm, Sm, Hhd, Hhd, Hhd, Hhd, Hhd, Rb^Edb, Rb, Md, Md, Md, Md, Md, Rb, Rb, Rb^Es, Rb, Md, Md, Md, Md, Md^Xm, Md^Xm, Md^Xm, Md^Xm, Md^Xm, Md^Xm, Md^Xm, Md^Xm, Rb, Md^Xm, Md^Xm, Md^Xm, Md^Xm, Md^Xm, Md^Xm, Md^Xm, Rb
