Rr, Rr, Rr, Rr, Rr, Rr, Rr, Rr, Rr, Rr, Rr, Rr, Rr, Rr, Rr, Rr, Rr, Rr
Rr, Rr, Rr, Rr, Rr, Rr, Rr, Rr, Rr, Rr, Rr, Rr, Rr, Rr, Rr, Rr, Rr, Rr
Rr, Rr, Rr, Rr, Rr, Rr, Rp, Rr, Rp, Rr, Rr, Rr, Rp, Rp, Rp, Rr, Rr, Rr
Rr, Rr, Rr, Rr, Rp, Rp, Rp, Rp, Rp, Rp, Rp^Vhcr, Rp, Rp, Rp, Rp, Rp, Rr, Rr
Rr, Rr, Rr, Rp^Vhcr, Rp, Rp, Rp, Rp, Rp, Rp, Rp, Rp, Rp^Vhcr, Rp, Rp, Rp, Rr, Rr
Rr, Rr, Rr, Rr, Rp, Rp, Rp, Rp, Rr^Vhc, Rp, Rr^Vhc, Rp, Rp, Rp, Rp, Rp, Rr, Rr
Rr, Rr, Rr, Rr, Rr, Rp, Rp^Vhcr, Rp^Vhcr, Rp, Rr^Vhc, Rp, Rp, Rp, Rp, Rp, Rr, Rr, Rr
Rr, Rr, Rr, Rp^Vhcr, Rr, Rr, Rr, Rr, Rr, Rr, Rp, Rp, Rp, Rp, Rp^Vhcr, Rr, Rr, Rr
Rr, Rr, Rr, Rr, Rp, Rr, Rr, Rr, Rr, Rp^Vhcr, Rp, Rp, Rp, Rp, Rp, Rr, Rr, Rr
Rr, Rr, Rp^Vhcr, Rp^Vhcr, Rp^Vhcr, Rr, Rp, Rp, Rr, Rr, Rp^Vhcr, Rp, Rp^Vhcr, Rp, Rr, Rr, Rr, Rr
Rr, Rr, Rp, Rp, Rp, Rp, Rr^Vhc, Rp, Rp^Vhcr, Rp, Rp, Rr, Rp, Rp, Rp, Rr, Rr, Rr
Rr, Rp, Rp, Rp^Vhcr, Rp, Rp, Rr^Vhc, Rp, Rp, Rp^Vhcr, Rp, Rp, Rp, Rp, Rp, Rp, Rp, Rr
Rp, Rp, Rp, Rp^Vhcr, Rp, 2 Rp, Rp^Vhcr, Rp, Rp, Rp, Rp, Rp, Rp, Rr^Vd, Rp, Rp, Rp, Rp
Rp, Rp, Rp^Vhcr, Rp^Vhcr, Rp, Rp, Rp, Rp^Vhcr, Rp^Vhcr, Rp, Rp, Rp, Rp, Rp, Rp, Rp, Rp, Rp
Rp, Rp, Rp^Vhcr, Rp, Rp, Rp, Rp, Rp, Rp, Rp^Vhcr, Rp^Vhcr, Rp, Rp, Rp^Vhcr, Rp, Rp, Rp, Rp
Rp, Rp, Rp, Rp, 1 Rp, Rp, Rp, Rp, Rp, Rp, Rp, Rp, Rp, Rp, Rp, Rp, Rp, Rp
Rp, Rp, Rp, Rp, Rp, Rp, Rp, Rp, Rp, Rp, Rp, Rp, Rp, Rp, Rp, Rp, Rp, Uu^Vu
Rp, Rp, Rp, Rp, Rp, Rp, Rr, Rp, Rp, Rp, Rp, Rp, Rp, Rp, Rp, Rp, Rp, Rp
